000000000000000a0
00000000000000000
00000000000000000
00000000000000000
00000000000000000
00000000000000000
000000000000000dl
00000000000000lld
00000000000000ldd
00000000000000ldd